                SetFood = new Func<string, int, bool>(QuestAPI.SetFood);
                SetDrink = new Func<string, int, bool>(QuestAPI.SetDrink);
                GetWEPWUser = new Func<string>(PluginAPI.PluginAPI.GetWEPWUser);
                GetPlayer = new Func<WowUnit>(PluginAPI.PluginAPI.GetPlayer);
                CastSpell = new Action<string>(PluginAPI.PluginAPI.CastSpell);
                UseMacro = new Action<string>(PluginAPI.PluginAPI.UseMacro);
                Log = new Action<string>(PluginAPI.PluginAPI.Log);
                UnitHasAura = new Func<WowUnit, string, bool>(PluginAPI.PluginAPI.UnitHasAura);
                GetUnitsList = new Func<List<WowUnit>>(PluginAPI.PluginAPI.GetUnitsList);
                GetObjectList = new Func<List<WowObject>>(PluginAPI.PluginAPI.GetObjects);
                GetPlayersList = new Func<List<WowUnit>>(PluginAPI.PluginAPI.GetPlayersList);
                InteractWithObject = new Action<WowObject>(PluginAPI.PluginAPI.InteractWithObject);
                InteractWithUnit = new Action<WowUnit>(PluginAPI.PluginAPI.InteractWithUnit);
                Sleep = new Action<int>(PluginSleep);
                IsObjectBobbing = new Func<WowObject, bool>(PluginAPI.PluginAPI.IsObjectBobbing);
                IsObjectValid = new Func<WowObject, bool>(PluginAPI.PluginAPI.IsObjectValid);
                GetBOTState = new Func<string>(PluginAPI.PluginAPI.GetBOTState);
                SetBOTState = new Action<string>(PluginAPI.PluginAPI.SetBOTState);
                SendKey = new Action<int, int>(PluginAPI.PluginAPI.SendKey);
                FaceUnit = new Action<WowUnit>(FaceUnit);
                GetStuckTime = new Func<int>(PluginAPI.PluginAPI.GetStuckTime);
                IsObjectOwnedByPlayer = new Func<WowObject, bool>(PluginAPI.PluginAPI.IsObjectOwnedByPlayer);
                Path = new Func<bool>(BasicPathCall);                
                GetCurrentPoint = new Func<int>(PluginAPI.PluginAPI.GetCurrentPoint);                               
                GetCurrentPath = new Func<Vector3[]>(PluginAPI.PluginAPI.GetCurrentPath);
                GetCurrentPathSize = new Func<int>(PluginAPI.PluginAPI.GetCurrentPathSize);
                FindMeshPathToUnit = new Func<WowUnit,bool>(FindMeshPathToUnit);
                FindMeshPathToObject = new Func<WowObject, bool>(FindMeshPathToObject);
                FindMeshPathUsingZoneCords = new Func<float, float, string, int, bool>(FindMeshPathUsingZoneCords);
                IsUnitValid = new Func<WowUnit, bool>(PluginAPI.PluginAPI.IsUnitValid);
                FindMeshPathToPoint = new Func<float,float,float, bool>(FindMeshPathToPoint);
                TargetUnit = new Action<WowUnit>(PluginAPI.PluginAPI.TargetUnit);
                GetTargetUnit = new Func<WowUnit>(PluginAPI.PluginAPI.GetTargetUnit);
                UseCommand = new Action<string>(PluginAPI.PluginAPI.UseCommand);
                BlackListPoint = new Action<float, float, float>(BlackListPoint);
                GetUnitReaction = new Func<WowUnit, WowUnit, int>(PluginAPI.PluginAPI.UnitReaction);
                GetUserName = new Func<string>(PluginAPI.PluginAPI.GetUserName);
                CompareGUID = new Func<WowGuid, WowGuid, bool>(PluginAPI.PluginAPI.CompareGUID);
                FindUnitByGUID = new Func<WowGuid, WowUnit>(PluginAPI.PluginAPI.FindUnitByGUID);
                DistanceToUnit = new Func<WowUnit, WowUnit, int>(PluginAPI.PluginAPI.DistanceToUnit);
                DistanceBetweenPoints = new Func<float[], float[], int>(PluginAPI.PluginAPI.DistanceBetweenPoints);
                UnitPosToFloatArray = new Func<WowUnit, float[]>(PluginAPI.PluginAPI.UnitPosToFloatArray);
                VecToFloatArray = new Func<Vector3, float[]>(PluginAPI.PluginAPI.VecToFloatArray);
                UseItem = new Action<string>(PluginAPI.PluginAPI.UseItem);
                GetZ = new Func<float, float, float>(PluginAPI.PluginAPI.GetZ);
                SleepPlugin = new Func<int,bool>(PluginAPI.PluginAPI.SleepPlugin);
                StopMoving = new Func<bool>(PluginStopMovingForward);
                GetUnitGUIDBlackList = new Func<WowGuid[]>(PluginAPI.PluginAPI.GetUnitGUIDBlackList);
                BlackListUnitGUID = new Func<WowUnit,bool>(PluginAPI.PluginAPI.BlackListUnitByGUID);
                GetZoneID = new Func<int>(PluginAPI.PluginAPI.GetZoneID);
                GetMapID = new Func<int>(PluginAPI.PluginAPI.GetMapID);
                GetAreaID = new Func<int>(PluginAPI.PluginAPI.GetAreaID);
                GetCorpsePos = new Func<Vector3>(PluginAPI.PluginAPI.GetCorpsePos);
                IsUnitLootable = new Func<WowUnit, bool>(PluginAPI.PluginAPI.IsUnitLootable);
                IsNodeInWater = new Func<WowObject, bool>(IsNodeInWater);
                IsPointInWater = new Func<float, float, float, bool>(IsPontInWater);
                AmIDead = new Func<bool>(AmIDead);
                AttemptToRessMe = new Func<bool>(WrapAttemptToRessMe);
                HasSpell = new Func<int, bool>(PluginAPI.PluginAPI.HasSpell);
                FindPlayerByName = new Func<string, WowUnit>(PluginAPI.PluginAPI.FindPlayerByName);
                FindUnitByName = new Func<string, WowUnit>(PluginAPI.PluginAPI.FindUnitByName);
                FindObjectByName = new Func<string, WowObject>(PluginAPI.PluginAPI.FindObjectByName);
                GetNearestRepair = new Func<TriNPCInfo>(PluginAPI.PluginAPI.GetNearestRepair);
                GetNearestVendor = new Func<TriNPCInfo>(PluginAPI.PluginAPI.GetNearestVendor);